"aa" = (/turf{tag = "title_location"},/area)
"dW" = (/turf,/area)

(1,1,1) = {"
dWdWdWdWdWdWdWdWdWdWdWdWdWdWdWdWdWdWdW
dWdWdWdWdWdWdWdWdWdWdWdWdWdWdWdWdWdWdW
dWdWdWdWdWdWdWdWdWdWdWdWdWdWdWdWdWdWdW
dWdWdWdWdWdWdWdWdWdWdWdWdWdWdWdWdWdWdW
dWdWdWdWdWdWdWdWdWdWdWdWdWdWdWdWdWdWdW
dWdWdWdWdWdWdWdWdWdWdWdWdWdWdWdWdWdWdW
dWdWdWdWdWdWdWdWdWdWdWdWdWdWdWdWdWdWdW
dWdWdWdWdWdWdWdWdWdWdWdWdWdWdWdWdWdWdW
dWdWdWdWdWdWdWdWdWdWdWdWdWdWdWdWdWdWdW
dWdWdWdWdWdWdWdWdWdWdWdWdWdWdWdWdWdWdW
dWdWdWdWdWdWdWdWdWdWdWdWdWdWdWdWdWdWdW
dWdWdWdWdWdWdWdWdWdWdWdWdWdWdWdWdWdWdW
aadWdWdWdWdWdWdWdWdWdWdWdWdWdWdWdWdWdW
"}
